NO ./imgs/south.xpm
SO ./imgs/south.xpm
WE ./imgs/west.xpm
EA ./imgs/east.xpm

F 227,100,0
C 225,30,0

1111111111111111111111111
10000N0000000000000000001
1000000000000000000000001
1111111111111111111111111

1111111111111111111111111
1000000000000000000000001
1000000000000000000000001
1111111111111111111111111
