NO ./imgs/north.xpm
SO ./imgs/south.xpm
WE ./imgs/west.xpm
EA ./imgs/east.xpm


F 220,100,0
C 225,30,0

1111111111111111111111111
10000N0000000000000000001
1000000000000000000000000001
1111111111111111111111111
